NO  textures/palestine.xpm
SO  textures/palestine.xpm
WE  textures/W.xpm
EA  textures/W.xpm
F 0,0,0
C 0,0,0

        1111111111111111111111111
        100000000110000000000001
        1011000001110000000000001
        100100000000000000000001
11111111101100000111000000000001
100000000011000001110111111111111
111101111111110111000000100011111111111111111111111111111
111101111111110111010100100000000000000000000000000000001
110000001101010111000000100011111111111111111111111111111
10000000000000000000000000001 
10000000000000001101000000001
10000000000000001101000000001
10000000000000001101000000001
1000000000000000110100000N001
10000000000000001101000000001
1111111111111111111111111111